alias configured: USE `plug help` FOR INFO

SEE: https://github.com/imjp94/gd-plug-ui

godot --headless -s plug.gd {action} {options...}

init	Initialize current project by creating plug.gd at root
status	Check the status of plugins(installed, added or removed), execute this command whenever in doubts
install alias update	Install or update(to latest version if not freezed) "plugged" plugins based on plug.gd, or uninstall "unplugged" plugins
uninstall	Uninstall all plugins, regardless of plug.gd
clean	Clean unused files/folders from /.plugged
upgrade	Upgrade addons/gd-plug/plug.gd to the latest version
version	Print current version of gd-plug
help	Show help

Options:
production	Install only plugins not marked as dev, or uninstall already installed dev plugins
test	Testing mode, no files will be installed/uninstalled while files to be installed/uninstalled will be printed, mainly used with install or uninstall
force	Force gd-plug to overwrite destination files when running install command. By default, gd-plug will terminate installation of plugin when any of the file found to be overwriting user files.
keep-import-file	Keep ".import" files generated by plugin, when run uninstall command
keep-import-resource-file	Keep files located in /.import that generated by plugin, when run uninstall command
debug alias d	Print debug message
detail	Print with datetime and log level, "[{time}] [{level}] {msg}"
quiet alias q, silent	Disable logging
